R 1920 1080
NO ./textures/no_texture.xpm
SO ./textures/so_texture.xpm
EA ./textures/ea_texture.xpm
S ./textures/ea_texture.xpm
X 225,30,30
WE ./textures/we_texture.xpm
F 220,100,252
C 225,30,30

111111111
100000001
100000001
100000001
100000001
100000001
100000001
100000001
1000000001111111111111111111
1111111110000000000000001001
       100000000000000000101
       110000000011000000101
       1000000002000000N1101
       100000000000000000101
       111111111111111111111