R 1920 1080
NO ./textures/no_texture.xpm
SO ./textures/so_texture.xpm
WE ./textures/we_texture.xpm
EA ./textures/ea_texture.xpm
S ./textures/s_texture.xpm
F 220,100,10
C 225,30,0

111111111
100000001
100000001
100000001
100000001
100000001
100000001
100000001
1000000001111111111111111101
1101111000000000000000000101
       110000000000000000101
       1100000000  000000101
       10000000020000000N001
       100000000000000000001
       111111111111111111111