R 1920 1080
NO ./textures/no_texture.xpm
SO ./textures/so_texture.xpm
WE ./textures/we_texture.xpm
EA ./textures/ea_texture.xpm
S ./textures/s_texture.xpm
F 220,100,10
C 225,30,0

                    111
                111110111111
         1111111000000000000111111111
      1110000000000000000000000000000111
   1110000000000000000000000000000000000111
 11000000000000000000000000000000000000000001
1000000000000000000000000000000000000000000001
1000000000000000000000000000000000000000000001
1000000000000000000000000000000000000000000001
1000000000000000000000000000000000000000001001
1000000000000000000000000000000000000000000001
1000000000000000000000000000000000000000001001
100000000000000000000E000000000000000000000001
1000000000000000000000000000000000000000000001
 10000000000000000000000000000000000000000001
  10000000000000     00000000000000000000001
   1000000000000     0000000000000000000001
    100000000000     000000000000000000001
     10000000000     00000000000000000001
      1000000000     0000000000000000001
 2     10000000000000000000000000000001
        110000000000000000000000000011
         111100000000000000000000111
            111111111111111111111