NO ./textures/no_texture.xpm
SO ./textures/so_texture.xpm
WE ./textures/we_texture.xpm
C 225,30,0
EA ./textures/ea_texture.xpm
S ./textures/s_texture.xpm
F 200,100,10
R 2880 1800

11111                 11111
100001               100001
1000001             1000101
 1000001           1000001 
  1000001         1000001  
   1000001       1000001   
    1000001     1000001    
     1000001   1000001    
      1000001111000001      
     10000000000000001     
    1000001111111000N01    
   1000001       1000001   
  1000011         1000001  
 100001            1000001 
111111              111111 