R 1920 1080
NO ./textures/no_texture.xpm
SO ./textures/so_texture.xpm
WE ./textures/we_texture.xpm
EA ./textures/ea_texture.xpm
S ./textures/s_texture.xpm
F 220,100,10
C 225,30,0

11111                 11111
100001               10N001
1000001             1000001
 1000001           1000001
  1000001         1000001
   1000001       1000001
    1000001     1000001
     1000001   1000001
      100000111000001
     10000000000000001
    1000001110111000001
   1000001       1000001
  100001          1000001
 100001            1000001
111111              111111